{
                            {8,8,8,8,8,8,8,8,8,8,8,8,8,8,8,8,8,8,8,8,8,8,8,8,8,8,8,8,8,8,8,8,8,8,8,8,8,8,8,8},
                            {8,0,4,4,4,4,4,4,4,4,4,4,4,4,0,8,8,8,8,0,8,8,0,4,4,4,0,8,8,0,8,8,8,8,8,8,8,8,8,8},
                            {8,8,8,8,8,8,8,8,8,8,8,8,8,8,1,8,8,8,8,8,8,8,8,8,8,8,8,8,8,8,8,8,0,4,0,4,4,0,8,8},
                            {8,8,8,8,8,8,8,0,8,8,8,8,8,8,0,4,4,4,4,4,4,4,4,4,4,4,4,0,8,8,0,8,8,8,1,8,8,8,8,8},
                            {8,0,8,8,8,8,8,1,8,8,8,8,8,8,1,8,8,8,8,8,8,8,8,8,8,8,8,1,8,8,8,8,8,8,1,8,8,8,8,8},
                            {8,1,8,8,8,8,8,0,4,4,0,8,8,8,1,8,8,8,0,8,8,8,8,8,8,8,8,0,8,0,8,8,8,8,1,8,8,8,8,8},
                            {8,1,8,8,8,8,8,1,8,8,1,8,8,8,1,8,8,8,1,8,0,8,8,8,8,8,8,8,8,8,8,8,8,8,1,8,8,8,8,8},
                            {8,1,8,8,8,8,8,1,8,8,1,8,8,8,1,8,8,0,0,4,1,8,8,8,8,8,8,0,4,4,4,4,4,4,0,4,0,8,8,8},
                            {8,0,4,4,4,4,4,0,8,8,0,8,8,8,1,8,8,8,8,8,1,4,4,0,8,8,8,0,8,8,8,8,8,8,8,8,8,8,8,8},
                            {8,8,8,8,8,8,8,1,8,8,8,8,8,8,1,8,8,8,8,8,0,8,8,8,8,8,8,8,8,8,8,8,8,8,8,8,8,8,8,8},
                            {8,8,8,8,8,8,8,0,8,8,0,8,8,8,1,8,8,8,8,8,8,8,8,8,8,8,8,8,8,8,8,8,8,8,8,8,8,8,8,8},
                            {8,8,8,8,8,8,8,8,8,8,1,8,8,8,0,4,4,4,4,4,4,4,4,4,4,4,0,4,4,4,0,4,4,4,4,0,8,8,8,8},
                            {8,8,8,8,8,0,4,4,0,8,1,8,8,8,8,0,8,8,8,8,8,8,8,8,8,8,1,8,8,8,1,8,8,8,8,1,8,8,8,8},
                            {8,8,8,8,8,1,8,8,8,8,1,8,8,8,8,8,8,8,8,8,8,8,8,8,8,8,1,8,8,8,1,8,0,8,8,1,8,8,8,8},
                            {8,8,8,8,8,1,8,8,8,8,1,8,8,0,8,8,8,0,8,8,8,8,8,8,8,8,1,8,8,8,1,8,0,8,8,0,4,0,8,8},
                            {8,8,0,8,8,1,8,8,8,8,1,8,8,8,8,8,8,8,8,8,8,0,4,4,4,4,0,8,0,8,1,8,8,8,8,1,8,8,8,8},
                            {8,8,1,8,8,0,4,4,4,4,0,8,8,8,8,8,8,8,8,0,8,8,8,8,8,8,1,8,8,8,0,8,8,8,8,1,8,8,8,8},
                            {8,8,1,8,8,1,8,8,8,8,1,8,8,8,8,8,8,8,8,1,8,8,8,8,8,8,1,8,8,8,8,8,0,0,4,0,8,8,8,8},
                            {8,8,1,8,8,1,8,8,8,8,1,8,8,8,8,0,4,4,4,0,4,4,4,0,8,8,1,8,0,8,8,8,8,1,8,8,8,8,8,8},
                            {8,8,1,8,8,0,8,8,8,8,1,8,0,8,8,1,8,8,8,1,8,8,8,8,8,8,1,8,8,8,8,8,8,1,8,8,8,8,8,8},
                            {8,8,1,8,8,8,8,8,8,8,1,8,8,8,8,1,8,8,8,1,8,8,0,8,8,8,1,8,8,8,0,4,4,0,8,8,0,8,8,8},
                            {8,8,1,8,8,8,8,0,8,8,1,8,8,8,8,1,8,0,8,1,8,8,8,8,8,8,1,8,8,8,8,8,8,1,8,8,1,8,8,8},
                            {8,8,1,8,8,0,8,8,8,8,1,8,0,8,8,0,8,8,8,0,4,4,4,4,4,4,0,4,0,8,8,8,8,1,8,8,1,8,8,8},
                            {8,8,1,8,8,1,8,8,8,8,1,8,8,8,8,8,8,8,8,8,8,8,8,8,8,8,1,8,8,8,8,8,8,1,8,8,1,8,8,8},
                            {8,8,0,8,8,0,4,4,4,4,0,8,8,8,0,4,4,4,4,4,4,4,4,4,4,4,0,8,8,8,8,8,8,1,8,8,1,8,8,8},
                            {8,8,8,8,8,8,8,8,8,8,8,8,8,8,8,8,8,8,8,8,8,8,8,8,8,8,8,8,8,8,0,4,4,0,4,4,0,8,8,8},
                            {8,8,8,8,8,8,8,8,8,0,8,0,0,8,8,8,8,0,8,8,8,8,0,8,8,8,8,8,8,8,8,8,8,1,8,8,1,8,8,8},
                            {8,0,0,0,8,8,0,8,8,8,8,0,4,4,0,8,8,8,8,8,8,8,1,8,8,8,0,8,8,8,8,8,8,1,8,8,1,8,8,8},
                            {8,8,1,8,8,8,1,8,8,8,8,8,8,8,1,8,8,8,8,0,4,0,4,0,8,8,8,8,0,8,8,8,8,1,8,8,1,8,8,8},
                            {8,8,0,8,8,8,0,4,4,4,4,4,4,4,0,8,8,8,8,8,8,1,8,8,8,8,8,8,1,8,8,8,8,0,8,8,1,8,8,8},
                            {8,8,8,8,8,8,1,8,8,8,8,8,8,8,1,8,8,8,8,8,8,1,8,8,8,8,8,8,1,8,0,8,8,8,8,8,1,8,8,8},
                            {8,8,8,8,8,8,1,8,8,8,8,8,8,8,1,8,8,8,8,8,8,1,8,8,8,8,8,8,1,8,8,8,8,8,8,8,1,8,8,8},
                            {8,8,0,4,4,4,0,8,8,0,4,0,8,8,0,4,4,4,4,4,4,4,4,4,4,4,0,8,1,8,8,8,8,8,8,8,1,8,8,8},
                            {8,8,8,1,8,8,1,8,8,8,1,8,8,8,1,8,8,8,8,8,8,8,8,8,8,8,8,8,1,8,8,0,4,0,8,8,1,8,8,8},
                            {8,8,8,1,8,8,1,8,8,8,1,8,8,8,1,8,8,8,8,8,8,8,8,8,0,8,8,8,1,8,8,8,8,1,8,8,1,8,8,8},
                            {8,8,8,1,8,8,1,8,8,8,1,8,8,8,1,8,8,0,4,4,4,0,8,8,1,8,8,8,1,8,8,8,8,0,4,4,0,8,8,8},
                            {8,8,8,0,8,8,1,8,8,8,1,8,8,8,1,8,8,8,8,1,8,8,8,8,1,8,8,8,0,4,4,4,4,4,0,8,8,8,8,8},
                            {8,8,8,8,8,8,1,8,8,8,1,8,8,8,0,8,8,8,8,1,8,8,8,8,0,8,8,8,8,8,8,8,8,8,4,8,8,8,8,8},
                            {8,0,4,0,8,8,0,8,8,0,0,0,8,8,8,8,8,8,8,0,8,8,8,8,8,8,8,0,8,8,0,8,8,8,0,8,8,8,8,8},
                            {8,8,8,8,8,8,8,8,8,8,8,8,8,8,8,8,8,8,8,8,8,8,8,8,8,8,8,8,8,8,8,8,8,8,8,8,8,8,8,8},
                         };